Scaffold	Position	Ref_Allele_Count	Alt_Allele_Count	Coverage_Depth	Alt_Allele_Frequency
1	11	7	64	71	0.901408451
1	16	10	90	100	0.9
2	9	79	86	165	0.521212121
2	12	12	73	85	0.858823529
2	67	54	96	150	0.64
3	8	0	0	0	0
4	99	86	28	114	0.245614035
4	101	32	25	57	0.438596491
4	115	97	16	113	0.14159292
5	6	86	43	129	0.333333333
5	19	59	27	86	0.313953488