Scaffold	Position	Ref_Allele_Count	Alt_Allele_Count	Coverage_Depth	Alt_Allele_Frequency
1	11	7	51	58	0.879310345
1	16	20	95	115	0.826086957
2	9	9	33	42	0.785714286
2	12	86	51	137	0.372262774
2	67	41	98	139	0.705035971
3	8	0	0	0	0
4	99	32	26	58	0.448275862
4	101	100	24	124	0.193548387
4	115	69	26	95	0.273684211
5	6	40	57	97	0.587628866
5	19	53	87	140	0.621428571